#native2ascii  -encoding utf8 studio_zh.txt studio_zh.properties 
File=文件
New=新建...
Open=打开...
Save=保存
SaveAs=另存为...
Close=关闭
OpenInExcel=打开Excel
Export=导出...
Chart=图表
Cancel=取消
Ok=确定
Undo=撤消
Redo=重复
Cut=剪切
Copy=复制
Paste=粘贴
SelectAll=全选
Find=查找...
Replace=替换...
Server=服务器
Database=数据库
Add=添加...
Edit=编辑
Remove=删除
Clone=克隆
Username=用户名
Password=密码
Query=查询
Execute=执行
Refresh=刷新
Window=窗口
Help=帮助
Exit=退出
NewWindow=新建窗口
ArrangeAll=全部重排
Stop=停止
ExecuteCurrentLine=执行当前行
ToggleDividerOrientation=切换拆分方向
Maximize editor pane=最大化编辑窗口
Minimize editor pane=最小化编辑窗口
Restore editor pane=还原编辑窗口
About=关于
ConsoleView=控制台视图
Table=表
rows=行
ServerList=服务器清单
